DS - CSI Crime Scene Investigation Dark Motives

Dicionário :

almost = quase
anywhere = qualquer lugar
dealing = lidando
either = ou
grew = cresceu
fears = medos
head = cabeça
inside = dentro
interviewed = entrevistado
linkages = ligações
listen = ouço
mine = meu
night shift = turno da noite
nightly = todas as noites
off
off all the new crime scene investigators
fora de todos os novos investigadores da cena do crime
over = sobre
promising = promissor
sharp = afiado
stunts = acrobracias
stuntman = dubê
tab = aba
trinity = trindade
waking = acordando
warrants = garantias
we're = nós somos
who
she's who you'll be working with on your first call
ela é com quem você trabalhará na sua primeira ligação
whose = de quem
you'll = você vai